NO Makefile

C 225,30,0

        SO Makefile
   EA Makefile


                
                 F             255,100,132
     WE                                     Makefile





  
        1111111111111111111111111
        1000000000110000000000001
        1011000001110000000000001
        1111111111111111111111111
        
        1111111111111111111111111
        1001000000000000000000001
111111111011000001110000000000001
100000000011000001110111111111111
11110111111111011100000010001
11110111111111011101010010001
11000010110101W11100000010001
100001 1000000001100000010001
10000010000000001101010010001
1100000111010101111101111000111
10110111 1110101 101111010001
11111111 1111111 111111111111
