NO Makefile

C 225,30,0

        SO Makefile
   EA Makefile


                
                 F             255,100,132
     WE                                     Makefile

111111
101001
100101
10N001
100001
111111