NO Makefile

C 225,30,0

        SO Makefile
   EA Makefile


                
                 F             255,100,132
     WE                                     Makefile

1111111
1010011
1000011
10N0111
1000111
1000111
1111111
1111111
1111111
11111111111111111111111111111111