NO Makefile

C 225,30,0

        SO Makefile
   EA Makefile


                
                 F             255,100,132
     WE                                     Makefile



1111111111
1000000001
1000000001
1000000001
100N000001
1000000001
1000000001
1000000001
1000000001
1111111111

