NO Makefile

C 225,30,0

        SO Makefile
   EA Makefile


                
                 F             255,100,132
     WE                                     Makefile






111111111111111111111111111111111111111111111111111111
100000000010000000001000000000100000000010000000011111
100000000000000000000000000000000000000010000000000001
100000000000000000000000000000000000000010000000000001
100000000000000000000000000000000000000010000000000001
100000000000000000000000000000000000000010000000000001
100000000000000000000000000000000000000010000000000001
100000000000000000000000000000000000000010000000000001
100000000000000000000000000000000000000000000000000001
100000000000000000000000000000000000000000000000000001
100000000000000000000000000000000000000000000000000001
100000000000000000000000000000000000000000000000000001
100000000000000000000000000000000000000000000000000001
100000000000000000000000000000000000000000000000000001
100000000000000000000000000000000000000000000000000001
100000000000000000000000000000000000000000000000000001
100000000000000000000000000000000000000000000000000001
100000000000000000000000000000000000000000000000000001
100000000000000000000000000000000000000000000000000001
10000000000000000000000000N000000000000000000000000001
111111111111111111111111111111111111111111111111111111

