NO Makefile

C 225,30,0

        SO Makefile
   EA Makefile


                
                 F             255,100,132
     WE                                     Makefile



11111111111111111111111111111111111111111111111111111111111
10000000000000000000000010000000000000000000000000000111111
10000000000000000000000010000000000000000000000000000111111
10000000000000000000000010000000000000000000000000000111111
10000000000000000000000010000000000000000000000000000111111
10000000000000000000000010000000000000000000000000000111111
10000000000000000000000010000000000000000000000000000111111
10000000000000000000000010000000000000000000000000000111111
10000000000000000000000000000000000000000000000000000111111
10000000000000000000000000000000000000000000000000000111111
10000000000000000000000000000000000000000000000000000111111
10000000000000000000000000000000000000000000000000000111111
10000000000000000000000001111111111111100000000000000111111
10000000000000000000000001000000000000000000000000000111111
10000000000000000000000001000000000000000000000000000111111
10000000000001000000000001000000000000000000000000000111111
10000000000001000000000001000000000000000000000000000111111
1000000N000001000000000001000000000000000000000000000111111
10000000000000000000000001000000000000000000000000000111111
11111111111111111111111111111111111111111111111111111111111

