NO ./ruta_a_la_textura_norte
        SO ./ruta_a_la_textura_sur
     WE                                     ./ruta_a_la_textura_oeste
	



   							
                 F             255,100,132
C 225,30,0

   EA ./ruta_a_la_textura_este




  11
  
        1111111111111111111111111
        1000000000110000000000001      1
        1011000001110000000000001
        1001000000000000000000001
111111111011000001110000000000001
100000000011000001110111111111111
11110111111111011100000010001
11110111111111011101010010001
11010000110101011100000010001
101 1000000000001100000010001
10010000000000001101010010001
11000001110101011111011110N0111
11110111 1110101 101111010001
11111111 1111111 111111111111

111
101
111


