north maps_and_media/textures/1.png


        south maps_and_media/textures/4.png
   east maps_and_media/textures/5.png

     west                                     maps_and_media/textures/2.png

                
C 40,40,40

                 F             151,151,151



111111111111
100000000001
100000000001
100000000001
100000000001
100000000001
10NXCR000001
100000000001
100000000001
100000000001
100000000001
111111111111