north maps_and_media/textures/1.png


        south maps_and_media/textures/4.png
   east maps_and_media/textures/5.png

     west                                     maps_and_media/textures/2.png

                
C 40,40,40

                 F             151,151,151


111111111111111111111111111111111111111111111111111111111111111111111111111111111111111111
100001100001100001100001100001100001100001100001100001100001100001100001100001100001100001
100001100001100001100001100001100001100001100001100001100001100001100001100001100001100001
100001100001100001100001100001100001100001100001100001100001100001100001100001100001100001
1000011000011000011000011000011000011000011000011000011000011000011000011000011000000000001
100001100001100001100001100001100001100001100001100001100001100001100000000001100001000001
100001100001100001100001100001100001100001100001100001100001100001100000000001100001100001
100000000001100001100001100001100000000000000000000000000000000001100000000001100001100001
100000000001100000000000000001100000000000000000000000000000000000000001100001100001100001
100000000001100000000000000001100000000000000000000000000000000000000001100001111111100001
100000000001100000000001100001100000000000000000000000000000000000000001100000000001100001
100000000001100000000001100001100000000000000000000000000000000000000001100000000001100001
100000000001100000000001100001100000000000000000000000000000000000000001100001100001100001
1000000000011000000000011000011000000000000000000000000000000000000000011000011000011000011111111
10000000000110000000000110000110000000000000000000000000000000000000000110000110000110000000000001
100000000001100000000001100001100000000000000000000000000000000001111111111111100011000000000000001
1000000000011000000000011000011000000000000000000000000000000000011000011000011000011000000000000001
1000000000011000000000011000011000000000000000000000000000000000011000011000011000011111111111000001
100000000000000000000000000001111111111111111111111111111111111111000000000000000000000001   1000001
100000000000000000000000000000000000111100000000000000000000000000010000000000000000000001   1000001
100000000000000000000000000000000000111100000000000000000000000000100000000000000000000001   1000001
100000000000000000000000000000000000000000011110000000000000001111000000000000000000000001   1000001
100000000000000000000000000000000000000000011110000000000000001111000000000000000000000001   1000001
100000000000000000000000000111101000000000011110000000000000001111000000000000000000000001   1000001
100000000000000000000000000100000000000000000000000000000000000000000000000000000000000001   1000001
100000000000000000000000000100000000000000000000000000000000000000000000000000000000000001   1000001
111111111111111111111111111100000000000000000000000000000000000000000000000000000000000001   1000001
100000000000000000000000000000000000000NX000000000N000000000000000000000000000000000000001   1000001
100000000000000000000000000000000000000000000000000000000000000000000000000000000000000001   1000001
111111111111111111111111111111111111111111110000000000000000000000000000000000000000000001   1000001
100000000000000000000000000000000000000000000000000000000000000000000000000000000000000001   1000001
111111111111111111111111111111111111111111110000000000000000001111111111111111111111111111   1000001
                                            100000000000000001                               1000001
                                             1000000000000001                                1000001
                                              10000000000001                                 1000001
                                               100000000001                                  1000001
                                                1000000001                                   1000001
                                                 10000001                                    1000001
                                                  100001            11111111111111111111111110000001
                                                  100001           10000000000000000000000000000001
                                                  100001          10000000000000000000000000000001
                                                  100001         10000001111111111111111111111111
                                                   10000111    110000001
                                                    1000001111100000011
                                                     1000000000000001
                                                      10000000000111
                                                       1111111111

















