NO wolf/4.png

C 225,30,0

        SO wolf/4.png

   EA wolf/4.png


                
                 F             0,255,0
     WE                                     wolf/4.png





        1111111111111111111111111
        1000000000110000000000001
        1011000001110000000000001
        1111111111111111111111111
        
        1111111111111111111111111
        1111111111111111111111111
        1111111111111111111111111
        1111111111111111111111111
        1111111111111111111111111
        1111111111111111111111111
        1111111111111111111111111
        1001000000000000000000001
111111111011000001110000000000001
100000000011000001110111111111111
11110111111111011100000010001
11110111111111011100000010001
11000010110101011100000010001
1000001000000N001100000010001
1100000111010101111101111000111
10110111 1110101 101111010001
11111111 111111 1111111111111
11111111 111111 1111111111111
11111111 111111 1111111111111
11111111 111111 1111111111111
11111111 111111 1111111111111
11111111 111111 1111111111111
11111111 111111 1111111111111
11111111 111111 1111111111111
11111111 111111 1111111111111
