NO textures/brick_normal.png

C 40,40,40

        SO textures/landscape.png
   EA textures/d64van-sky1pal.png
     WE                                     textures/PC Computer - Giana Sisters Twisted Dreams - Dungeon Walls.png


                
                 F             151,151,151



1111111111111111111
1000100000000000001
1000100000000000001
100010011111111111111111
100000000100000000000001
100000000100000011100001
100011100111110011100001
100010000000000000100001
10001000000000000010000011
11111111111111111110000011111111111111111111111111111111111111111111
10000000000000000000000000000000000000000000000000000000000000000001
10000000000000000000010000100000000000000000000000000000000000000001
11111111111111111111111111100000000000000000000000N00000000000000001
                          100000000000000000000000000000000000000001
                          100000000000000000000000000000000000000001
                          100000000000000000000000000000000000000001
                          100000000000000000000000000000000000000001
                          100000000000000000000000000000000000000001
                          100000000000000000000000000000000000000001
                          100000000000000000000000000000000000000001
                          100000000000000000000000000000000000000001
                          100000000000000000000000000000000000000001
                          100000000000000000000000000000000000000001
                          100000000000000000000000000000000000000001
                          100000000000000000000000000000000000000001
                          100000000000000000000000000000000000000001
                          100000000000000000000000000000000000000001
                          100000000000000000000000000000000000000001
                          100000000000000000010010000000000000000001
                          111111111111111111100001111111111111111111
                          100000000000000001000000010000000100000001
                          100000000000000001000000010000000100111111
                          100000011111111111000000010000000100000001
                          100000000000000001000000010000000100111111
                          100000000000000001000000010000000100000001
                          100000011111111111000000010000000100111111
                          100000000000000001000000010000000100000001
                          110000000000000001000000010000000100000001
                          111111111100000000000000000000000100011111
                          110000000000000000000000000000000000000001
                          110000000000000001000000010000000000000001
                          111111111111111111111111111111111111111111



































