NO textures/brick_normal.png

C 40,40,40

        SO textures/W3d_protoredbrick1.png
   EA textures/BrickFacade0006_1_download600.png
     WE                                     textures/PC Computer - Giana Sisters Twisted Dreams - Dungeon Walls.png


                
                 F             151,151,151

1111111
1000011
1000011
10N0111
1000111
1000111
1111111
1111111