NO Makefile

C 225,30,0

        SO Makefile
   EA Makefile


                
                 F             255,100,132
     WE                                     Makefile

1111111111111111111111111111111111111111111111111111111111
1000000000000000000000000000000000000000000000000000000001
1000000000000000000000000000000000000000000000000000000001
1000000000000000000000000000000000000000000000000000000001
1000000000000000000000000000000000000000000000000000000001
1000000000000000000000000000000000000000000000000000000001
1000000000000000000000000000000000000000000000000000000001
1000000000000000000000000000000000000000000000000000000001
1000000000000000000000000000000000000000000000000000000001
1000000000000000000011111110000000001111111000111111000001
1000000000000000000000000000000000000000000000000000000001
1000000000000000000000000000000000000000000000000000000001
1000000000000000000000000000000000000000000000000000000001
1000000000000000000000000000000000000010000000000000000001
1000000000000000000000000000000000000010000000000000000001
1000000000000000000000000111111100000010000000000000000001
1000000000000000000000000000000000000010000000000000000001
1000000000000000000000000000000000000010000000000000000001
1000000000000000000000000000000000000010000000000000000001
1000000000000000000000000001111000000000000000000000001001
1000000000000000000000000000000000000000011111100000000001
1000000000000000000000000000000000000000000000000000000001
1000000000000000000000001111110000000000000000000000000001
1000000000000000000000001111110000000000000000000000000001
1000000000000000000000001111110000000000000000000000000001
1000000000000000000000001111110000000000000000000000000001
1000000000000000000000000000000000000000000000000000000001
1000000000000000000000000000000000000000000000000000000001
1000000000000000000000000000000000000000000000000000100001
1000000000000000000000000000000000000000000000000000000001
1000000000000000000000000000000000000000000000000000000001
1000000000000000000000000000000000000000000000000100000001
1000000000000000000000000000000000000000000000000000000001
1000000000000000000000000000000000000000000000000000000001
1000000000000000000000000000000000000000000000000000000001
1000000000000000000000000000000000000000000000000000000001
1000000000000000000000000000000000000000000000000000000001
1000000000000000000000000000000000000000000000000000000001
1000000000000000000000000000000000000000000000000000000001
1000000000000000000000000000000000000000000000000000000001
1000000000000000000000000000000000000000000000000000000001
1000000000000000000000N00000000000000000000000000000000001
1000000000000000000000000000000000000000000000000000000001
1000000000000000000000000000000000000000000000000000000001
1000000000000000000000000000000000000000000000000000000001
1000000000000000000000000000000111000000000000000000000001
1000000000000000000000000000000001000000000000000000000001
1000000000000000000000000000000001000000000000000000000001
1000000000000000000000000000111111111110000000000000000011
1111111111111111111111111111111111111111111111111111111111