NO Makefile

C 225,30,0

        SO Makefile
   EA Makefile


                
                 F             255,100,132
     WE                                     Makefile

111111111111111111111111111111111111111111111111111111111111111111111111111111111111111111111111111111111111
100000000000000001000000000000010000000000000000000000000000000000000000000000000000000000000000000000000001
100000000000000001000000000000010000000000000000000000000000000000000000000000000000000000000000000000000001
100000000000000001000000000000010000000000000000000000000000000000000000000000000000000000000000000000000001
100000000000000001000000000000010000000000000000000000000000000000000000000000000000000000000000000000000001
100000000000000001000000000000010000000000000000000000000000000000000000000000000000000000000000000000000001
111111111000000001000000000000010000000000000000000000000000000000000000000000000000000000000000000000000001
100000001000000001000000000000010000000000000000000000000000000000000000000000000000000000000000000000000001
100000001000000001000000000000010000000000000000000000000000000000000000000000000000000000000000000000000001
100000001000000001000000000000010000000000000000000000000000000000000000000000000000000000000000000000000001
100000001000000001000000000000010000000000000000000000000000000000000000000000000000000000000000000000000001
100000001000000001000000000000010111111111111111111111111111111111100100000000000000000000000000000000000001
100000001111111111000000000000000000000000000000000000000000000000000100000000000000000000000000000000000001
100000000000000000000000000000000000000000000000000000000000000000000100000000000000000000000000000000000001
100000000000000000000000000000000000000000000000000000000000000000000100000000000000000000000000000000000001
100000000000000000000000000000000000000000000000000000000000000000000100000000000000000000000000000000000001
100000000000000000000000000000000000000000000000000000000000000000000100000000000000000000000000000000000001
100000000000000000000000000000000000000000000000000000000000000000000100000000000000000000000000000000000001
100000000000000000000000000000000000000000000000000000000000000000000100000000000000000000000000000000000001
100000000000000000000000000000000000000000000000000000000000000000000100000000000000000000000000000000000001
100000000000000000000000000000000000000000000000000000000000000000000100000000000000000000000000000000000001
100000000000000000000000000000000000000000000000000000000000000000000100000000000000000000000000000000000001
100000000000000000000000000000000000000000000000000000000000000000000100000000000000000000000000000000000001
100000000000000000000000000000000000000000000000000000000000000000000100000000000000000000000000000000000001
100000000000000000000000000000000000000000000000000000000000000000000100000000000000000000000000000000000001
100000000000000000000000000000000000000000000000000000000000000000000100000000000000000000000000000000000001
100000000000000000000000000000000000000000000000111111100000000000000100000000000000000000000000000000000001
100000000000000000000000000000000000000000000000100000100000000000000100000000000000000000000000000000000001
100000000000000000000000000000000000000000000000100000100000000000000100000000000000000000000000000000000001
10000000000000000000000000000000000000000000000010000010000000000000010000000000000000000111111111111111111111
10000000000000000000000000000000000000000000000010000010000000000000011111111111111111111100000000100000000001
10000000000000000000000000000000000000111111111110000011111110000000000000000000000000000000000000100000000001
10000000000000000000000000000000000000100000000000000000000000000000000000000000000000000111111111100000000001
10000000000000000000000000000000111111101111111111111111111110000000000000000000000000000100000000000000000111
100000000000000001000000000000010000000000000000000000000000100000000000000000000000000001000000000000000001
100000000000000001000000000000010000000000000000000000000000100000000000000000000000000001000000000000000001
100000000000000001000000000000010000000000000000000000000000100000000000000000000000000001000000000000000001
100000000000000001000000000000010000000000000000000000000000111111111111111111111111111111000000000000000001
100000000000000001000000000000010000000000000000000000000000000000000000000000000000001000000000000000000001
100000000000000001000000000000010000000000000000000000000000000000000000000000000000001000000000000000000001
100000000000000001000000000000010000000000000000000000000000000000000000000000000000001000000000000000000001
100000000000000001000000000000010000000000000000000000000000000000000000000000000000001000000000000000000001
100000000N00000001000000000000010000000000000000000000000000000000000000000000000000001000000000000000000001
100000000000000001000000000000010000000000000000000000000000000000000000000000000000001000000000000000000001
100000000000000001000000000000010000000000000000000000000000000000000000000000000000001000000000000000000001
100000000000000001000000000000010000000000000000000000000000000000000000000000000000001000000000000000000001
100000000000000001000000000000010000000000000000000000000000000000000000000000000000001000000000000000000001
100000000000000001000000000000010000000000000000000000000000000000000000000000000000001000000000000000000001
100000000000000001000000000000010000000000000000000000000000000000000000000000000000001000000000000000000001
100000000000000001000000000000010000000000000000000000000000000000000000000000000000001000000000000000000001
100000000000000001000000000000010000000000000000000000000000000000000000000000000000001000000000000000000001
100000000000000001000000000000010000000000000000000000000000000000000000000000000000001000000000000000000001
100000000000000001000000000000010000000000000000000000000000000000000000000000000000001000000000000000000001
100000000000000001000000000000010000000000000000000000000000000000000000000000000000001000000000000000000001
100000000000000001000000000000010000000000000000000000000000000000000000000000000000001000000000000000000001
100000000000000001000000000000010000000000000000000000000000000000000000000000000000000000000000000000000001
100000000000000001000000000000010000000000000000000000000000000000000000000000000000000000000000000000000001
100000000000000001000000000000010000000000000000000000000000000000000000000000000000000000000000000000000001
100000000000000001000000000000010000000000000000000000000000000000000000000000000000000000000000000000000001
100000000000000001000000000000010000000000000000000000000000000000000000000000000000000000000000000000000001
100000000000000001000000000000010000000000000000000000000000000000000000000000000000000000000000000000000001
100000000000000001000000000000010000000000000000000000000000000000000000000000000000000000000000000000000001
100000000000000001000000000000010000000000000000000000000000000000000000000000000000000000000000000000000001
100000000000000001000000000000010000000000000000000000000000000000000000000000000000000000000000000000000001
100000000000000001000000000000010000000000000000000000000000000000000000000000000000000000000000000000000001
100000000000000001000000000000010000000000000000000000000000000000000000000000000000000000000000000000000001
100000000000000001000000000000010000000000000000000000000000000000000000000000000000000000000000000000000001
100000000000000001000000000000010000000000000000000000000000000000000000000000000000000000000000000000000001
100000000000000001000000000000010000000000000000000000000000000000000000000000000000000000000000000000000001
100000000000000001000000000000010000000000000000000000000000000000000000000000000000000000000000000000000001
111111111111111111111111111111111111111111111111111111111111111111111111111111111111111111111111111111111111
