NO Makefile

C 225,30,0

        SO Makefile
   EA Makefile


                
                 F             255,100,132
     WE                                     Makefile



1111111111111111111
1000100000000000001
1000100000000000001
100010011111111111111111
100000000100000000000001
100000000100000011100001
100011100111110011100001
100010000000000000100001
1N001000000000000010000011
111111111111111111100000111
100000000000000000000000001
100000000000000000000000001
111111111111111111111111111



































